14 22 6
XXXXXXXXXXXXXXXXXXXXXX
XS           C   X6  X
X     X2         X   X
X                XXX X
X  1       X         X
X     X    X      5  X
X          X         X
X          X    XX   X
X    C              4X
X                    X
X   XXX            C X
X       3    XXXXX   X
X                    X
XXXXXXXXXXXXXXXXXXXXXX